-                                    -
-                                    -
-                                    -
-                                    -
-                                    -
-                                    -
-       *                    *       -
-       -                    -       -
-      --                    --      -
-       *                    *       -
-   ------                  ------   -
-                                    -
-       *                    *       -
--     --                    --      -
-      --                    --      -
-      ---                  ---      -
-    ----                    ----    -
-       -                    -       -
---                                ---
-           *            *           -
-       -   -            -   -       -
-       -- --            -- --       -
--------------------------------------
--------------------------------------