-                                    -
-                                    -
-                                    -
-                                    -
-----                            -----
---     *                    *     ---
--    ---                    ---    --
-      --                    --      -
-       -                    -       -
-       ---                ---       -
--   -----                  -----   --
-       -                    -       -
-       *                    *       -
-      --                    --      -
---     -                    -     ---
--      *                    *      --
-     ----                  ----     -
-        -                  -        -
-----    *                  *    -----
-       --                  --       -
-            -          -            -
-           ---        ---           -
--------------------------------------
--------------------------------------