-                                    -
-                                    -
-                                    -
-                                    -
-                                    -
-                                    -
-                                    -
-                                    -
-                                    -
-   -----                    -----   -
-   - -                        - -   -
-  -----                      -----  -
-      *                      *      -
-      -                      -      -
--   ----                    ----   --
-      -                      -      -
-      *                      *      -
---   --                      --   ---
-      --                    --      -
-      --                    --      -
-     --                      --     -
-   -     -                -     -   -
--------------------------------------
--------------------------------------